level 3
next_level assets/level_1.map
next_level assets/level_2.map
map
# # # # # # # # # # # # L # -1
# S 0 0 0 0 0 0 0 0 0 0 0 # -1
# 0 0 0 0 0 K 0 0 0 0 0 M # -1
# 0 B 0 0 0 0 0 0 0 0 H 0 # -1
# # # # # # # # # # # L # # -2