level 2
next_level assets/level_1.map
next_level assets/level_3.map
map
# # # # # # # # # # # # L # -1
# 0 0 0 0 0 0 0 0 0 0 0 S # -1
# 0 0 0 0 0 0 0 0 0 0 0 0 # -1
# K B 0 0 0 0 0 0 0 0 H 0 # -1
# # # # # # # # # # # L # # -2